xxxxxxxxxxx
xv        vx
x         x 
x   v     x
x         x   v
x         x 
x         x x x
xx         x x x
x  v       xxxxx 
x             x
xxxx         xxxxx
x  x      x
x         x
x         x
x      xxxx
x         x
x         x 
x x  x    x
x xxxx    x 
x    x    x
xxxxxxxxxxx